022225002512101
012121200122000
002225022512121
212121204122222
222225002512121
151515002515151
222220200121212
121215022522222
222221200121212
101215002522220
002221220121210
101215002522203