211211002112110
200211312002114
211211222112110
211211212112110
211011222114110
211011212110112
211011222110112
211011212110112
011411222110112
411211212112112
011211222112112
011200210112002
011211204112112